10
10
10
##########
#S       #
#        #
#        #
#        #
#        #
#        #
#        #
#       C#
##########