10
10
10
##########
#S      S#
#        #
#        #
#        #
#        #
#        #
#        #
#S      C#
##########