13
13
20
#############
#     # #  S#
# ####  #  ##
#   S#      #
#   ####    #
#      #  C #
# ###  ###  #
#  S#    #  #
#   #       #
#    # ### ##
#  ##   #   #
# T#S   #  S#
#############