13
13
15
#############
#    C  #  S#
# ####  #  ##
#   S#      #
#   ####    #
#           #
# ###       #
#  S#       #
#   #       #
#    # ### ##
#  ##   #   #
# T#S   #  S#
#############