10
10
15
##### ####
#   T#  S#
# ####  ##
#   S#   #
#   #C## #
#        #
# ###    #
#  S#    #
#   #    #
##########