15
15
25
###############
#    S B B    #
# B    #T# S  #
# ###### #### #
#          #  #
#      B B    #
#    #B S B#  #
#  #   BBB    #
#  C#   #     #
#B#B#B# #B#B#B#
#       #     #
# S    #  S   #
#     #   #   #
#T            #
###############