19
19
60
###################
#S               C#
# B # B B # B B T #
#                 #
# B B # B B # B B #
#S                #
# B T B # B B # B #
#                S#
# B B B B # B B # #
#                 #
# # B B T B # B B #
#S                #
# B # B B B B # B #
#                S#
# B B # B B T B # #
#                 #
# # B B # B B B B #
#S               S#
###################