15
15
20
###############
# S#          #
#  #  ## ##S  #
# #####B B### #
#   #      #  #
#   ###    #  #
#  #      #   #
#  #          #
#       C     #
#  #########B##
#      #S     #
#       #     #
#    #    #   #
#T   S#       #
###############